file = Dosya
function = Fonksiyon
exception =  <b>İstisna</b>: {2} satırındaki {1} dosyasında {0} 
an_exception_occurred = Bir istisna oluştu
trace = Hata İzleme
error = Hata
any = Hiç
running = Çalışıyor
not_running = Durduruldu
none = Yok
first_name = İlk Ad
last_name = Soyadı
email = E-posta
password = Şifre
country = Ülke
phone = Telefon
ok = Tamam
nok = NOK
username = Kullanıcı adı
warning = Uyarı
new = Yeni
disabled = Devre dışı
file_to_large = Seçilen dosya çok büyük, izin verilen boyut {0}
invalid_file_type =  Seçilen dosya tipi geçerli değil
refresh = Yenile
select_one = -- Birini Seç --
used_number = <b>{0}</b> numarası {1} modülü tarafından kullanılıyor.
extension = Dahili
unlimited = Sınırsız
system = Sistem
install = Yukle
duplicated_description = Girilen açıklama zaten kullanımda.
duplicated_extension = Girilen dahili zaten kullanımda.
edit = Düzenle
download = İndir
inherited = Miras
duplicated_number = Girilen numara zaten kullanımda.
default = Varsayılan
description = Açıklama
accept = Kabul Et
confirm = Onayla
restriction_msg = Talep edilen bilgileri alma, düzenleme veya silme izniniz yok
company = Şirket
license = Lisans
language = Dil
default_ringtime = Varsayılan ({0})
all = Her şey
report = Bildiri
from_date = Başlangıç Tarihi
to_date = Bitiş Tarihi
actions = Eylemler
download_csv_format = CSV Formatında İndir
no_file_selected = Hiçbir dosya seçmediniz
empty_file = Boş bir dosya seçtiniz
csv.invalid_file = CSV dosyası seçmediniz
select_country = -- Ülke Seç --
select_state = -- İl Seç --
continue = Devam Et