file = Fil
function = Funktion
exception = <b>Exception</b>: {0} på fil {1} på rad {2}
an_exception_occurred = Ett undantag har inträffat
trace = Felspårning
error = Fel
any = Alla
running = Körs
not_running = Stoppad
none = Ingen
first_name = Förnamn
last_name = Efternamn
email = E-post
password = Lösenord
country = Land
phone = Telefon
ok = OK
nok = NOK
username = Användarnamn
warning = Varning
new = Ny
disabled = Inaktiverad
file_to_large = Den valda filen är för stor, den tillåtna storleken är {0}
invalid_file_type =  Den valda filtypen är inte giltig
refresh = Uppdatera
select_one = -- Välj en --
used_number = Antalet <b>{0}</b> används av {1} modul.
extension = Anslutningar
unlimited = Obegränsad
system = System
install = Installera
duplicated_description = Den angivna beskrivningen är redan i bruk.
duplicated_extension = Den tillhandahållna anslutningen är redan i bruk.
edit = Redigera
download = Ladda ner
inherited = Ärvd
duplicated_number = Det angivna numret är redan i bruk.
default = Standard
description = Beskrivning
accept = Acceptera
confirm = Bekräfta
restriction_msg = Du får inte hämta, redigera eller radera den begärda informationen
company = Företag
license = Licens
language = Språk
default_ringtime = Standard ({0})
all = AllA
report = Rapportera
from_date = Startdatum
to_date = Slutdatum
actions = Åtgärder
download_csv_format = Ladda ner CSV-format
no_file_selected = Du har inte valt någon fil
empty_file = Du har valt en tom fil
csv.invalid_file = Du har inte valt en CSV-fil
select_country = -- Välj land --
select_state = -- Välj stat --
continue = Fortsätt
tenant = Abonnent
invalid_extension = Den angivna anslutningen/numret är ogiltigt. Endast *,#,+ och siffror är tillåtna.
page = Sida
