file = Arquivo
function = Função
exception = <b> Exceção </b>: {0} no arquivo {1} na linha {2}
an_exception_occurred = Uma exceção ocorreu
trace = Rastreio de Erros
error = Erro
any = Qualquer
running = Corrida
not_running = Parado
none = Nenhum
first_name = Primeiro nome
last_name = Último nome
email = O email
password = Senha
country = País
phone = Telefone
ok = Está bem
nok = NOK
username = Nome de usuário
warning = Atenção
new = Novo
disabled = Desativado
file_to_large = O arquivo selecionado é muito grande, o tamanho permitido é {0}
invalid_file_type = O tipo de arquivo selecionado não é válido
refresh = Atualizar
select_one = -- Selecione um --
used_number = O número <b>{0}</b> está sendo usado pelo módulo {1}.
extension = Ramal
accept = Aceitar
company = Empresa
confirm = Confirmar
default = Padrão
description = Descrição
download = Download
duplicated_description = A descrição fornecida já está em uso.
duplicated_extension = O ramal fornecido já está em uso.
duplicated_number = O número fornecido já está em uso.
edit = Editar
inherited = Inherited
install = Instalar
license = Licença 
restriction_msg = Você não tem permissão para acessar, editar ou deletar a informação solicitada
system = Sistema
unlimited = Ilimitado
actions = Actions
all = All
csv.invalid_file = You have not selected a CSV file
default_ringtime = Default ({0})
download_csv_format = Download CSV Format
empty_file = You have selected an empty file
from_date = Start Date
language = Language
no_file_selected = You have not selected any file
report = Report
to_date = End Date
select_country = -- Select Country --
select_state = -- Select State --
continue = Continue
tenant = Tenant
