file = File
function = Funzione
exception = <b>Exception</b>: {0} at file {1} on line {2}
an_exception_occurred = Si e' verificata un'eccezione
trace = Error Trace
error = Errore
any = Ogni
running = In Esecuzione
not_running = Fermato
none = None
first_name = Nome
last_name = Cognome
email = Email
password = Password
country = Paese
phone = Telefono
ok = OK
nok = NOK
username = Username
warning = Avviso
new = Nuovo
disabled = Disabilitato
file_to_large = Il file selezionato e' troppo grande, la dimensione consentita e' {0}
invalid_file_type =  Il tipo di file selezionato non e' valido
refresh = Aggiorna
select_one = -- Selezionare --
used_number = Il numero <b>{0}</b> e' gia' usato dal modulo {1} .
extension = Interno
unlimited = Illimitato
system = Sistema
install = Installa
duplicated_description = La descrizione fornita e' gia' in uso.
duplicated_extension = L'estensione fornita e' gia' in uso.
edit = Modifica
download = Scarica
inherited = Eredidato
duplicated_number = Il numero fornito e' gia' in uso.
default = Default
accept = Accetta
company = Company
confirm = Confirma
description = Descrizione
license = Licenza
restriction_msg = Non puoi ottenere, modificare o eliminare le informazioni richieste.actions = Actions
all = All
csv.invalid_file = You have not selected a CSV file
default_ringtime = Default ({0})
download_csv_format = Download CSV Format
empty_file = You have selected an empty file
from_date = Start Date
language = Language
no_file_selected = You have not selected any file
report = Report
to_date = End Date
